R 1920 1080
NO ./textures/redbrick.xpm
SO ./textures/mossy.xpm
WE ./textures/stone.xpm
EA ./textures/wood.xpm
S ./textures/barrel.xpm
F 220,100,0
C 225,30,0


11111111111111111111111
1000000000100000000200111111111111111111
100000000000000000000000000000011111111111111111111111
100000000000000000000000000010000000000011111111111111
111111111111100000000001111111111111111111111111111111
11111111111111111111111111111111111100000N00001
11111111111111111111111111111111111111111111111



1 1 1 1 1111111111
     1 0 0 N 0 0 1
     1 0 1 0 0 0 01
1 1 1 0 0 1111111111
1 1 1 1 1 1