R 1920 1080
NO ./textures/redbrick.xpm
SO ./textures/mossy.xpm
WE ./textures/stone.xpm
EA ./textures/wood.xpm
S ./textures/barrel.xpm
F 220,100,0
C 225,30,0


11111111111111111111111
111100000000000000111111
111111111111110200011111
           1110000000111111111
         111111000N0000111111
111111111100000001111111
111111111111111111