R 1920 1080
NO ./textures/redbrick.xpm
SO ./textures/mossy.xpm
WE ./textures/stone.xpm
EA ./textures/wood.xpm
S ./textures/barrel.xpm
F 220,100,0
C 225,30,0

11111111111
11100N001
1110000001
1110000011
1111111111