R 1920 1080
NO ./textures/redbrick.xpm
SO ./textures/mossy.xpm
WE ./textures/stone.xpm
EA ./textures/wood.xpm
S ./textures/barrel.xpm
F 220,100,0
C 225,30,0


11111111111111111111111
100000000200000000101
100000000000000000111
100000000000000000111
1000000000000000001111
100000000N0000000011
1111111111111111111