R 1920 1080
NO ./img/v.xpm
SO ./img/2.xpm
WE ./img/3.xpm
EA ./img/4.xpm
S ./img/s.xpm
F 220,100,0
C 225,30,0

0000000000000000000000000000000000011111111111
11111111111111111111111111111111111100000200001
1000000000000000000000000000001000000002020200111111111111111111111111111111111
10000000000000000000000000000010000000000200000000000000000000000000000000001
10000000000000000000000000000000000000000200000000000000000000001000000000001
1111111111111111111111111111111111110000000000111111111111111111111111111111111
11111111111111111111111111111111111100000N00001
0000000000000000000000000000000000011111111111
