R 1920 1080
NO ./img/v.xpm
SO ./img/2.xpm
WE ./img/3.xpm
EA ./img/4.xpm
S ./img/s.xpm
F 173,170,103
C 242,191,99


1111111111111111
1002000000000001
1000000020000001
1000000000000001
10000000N0000001
1000000000000001
1111111111111111