R 1920 1080
NO ./textures/redbrick.xpm
SO ./textures/mossy.xpm
WE ./textures/stone.xpm
EA ./textures/wood.xpm
S ./textures/barrel.xpm
F 220,100,0
C 225,30,0

0000000000000000000000000000000000011111111111
11111111111111111111111111111111111100000000001
1000000000000000000000000000001000000002000200111111111111111111111111111111111
10000000000000000000000000000010000000000000000000000000000000000000000000001
10000000000000000000000000000000000000000000000000000000000000001000000000001
1111111111111111111111111111111111110000000000111111111111111111111111111111111
11111111111111111111111111111111111100000N00001
0000000000000000000000000000000000011111111111
